Qxua, Qxua, Qxua, Qxua, Qxua, Qxua, Qxua, Qxua, Qxua, Qxua, Qxua, Qxua, Qxua, Qxua, Qxua, Qxua, Qxua, Qxua, Qxua, Qxua, Qxua, Qxua, Qxua, Qxua, Qxua, Qxua, Qxua, Qxua, Qxua, Qxua, Qxua, Qxua, Qxua, Qxua, Qxua, Qxua, Qxua, Qxua, Qxua, Qxua, Qxua, Qxua, Qxua, Qxu, Qxua, Qxua, Qxua, Qxua, Qxua, Qxua, Qxua, Qxua, Qxua, Qxua, Qxua, Qxua, Qxua, Qxua, Qxua, Qxua, Qxua, Qxua, Qxua, Qxua, Qxua, Qxua, Qxua, Gg
Qxua, Qxua, Qxua, Qxua, Qxua, Qxua, Qxua, Qxua, Qxua, Qxua, Qxua, Qxua, Qxua, Qxua, Qxua, Qxua, Qxua, Qxua, Qxua, Qxua, Qxua, Qxua, Qxua, Qxua, Qxua, Qxua, Qxua, Qxua, Qxua, Qxua, Qxua, Qxua, Qxua, Qxua, Qxua, Qxua, Qxua, Qxua, Qxua, Qxua, Qxua, Qxua, Qxua, Qxua, Qxua, Qxua, Qxua, Qxua, Qxua, Qxua, Qxua, Qxua, Qxua, Qxua, Qxua, Qxua, Qxua, Qxua, Qxua, Qxua, Qxua, Qxua, Qxua, Qxua, Qxua, Qxua, Qxua, Qxua
Qxua, Qxua, Qxua, Qxua, Qxua, Qxua, Qxua, Qxua, Qxua, Qxua, Qxua, Qxua, Qxua, Qxua, Qxua, Qxua, Qxua, Qxua, Qxua, Qxua, Qxua, Qxua, Qxua, Qxua, Qxua, Qxua, Qxua, Qxua, Qxua, Qxua, Qxua, Qxua, Qxua, Qxua, Qxua, Qxua, Qxua, Qxua, Qxua, Qxua, Qxua, Qxua, Qxua, Qxua, Qxua, Qxua, Qxua, Qxua, Ms^Xm, Ms^Xm, Aa^Fpa, Ms^Xm, Ms^Xm, Ms^Xm, Ms^Xm, Ms^Xm, Ms^Xm, Qxua, Qxua, Qxua, Qxua, Qxua, Qxua, Qxua, Qxua, Qxua, Qxua, Qxua
Qxua, Qxua, Qxua, Qxua, Qxua, Qxua, Qxua, Qxua, Qxua, Qxua, Qxua, Qxua, Qxua, Qxua, Qxua, Qxua, Qxua, Qxua, MdaZ, Qxua, MdaZ, Qxua, Qxua, Qxua, Qxua, Qxua, Xuc, Qxua, Uu^Vud, Qxua, UheY, Qxua, UheY, Xuc, Xuc, Ms^Xm, Ms^Xm, Qxua, Ms^Xm, Ms^Xm, Ms^Xm, Qxua, Qxua, Qxua, Ms^Xm, Ms^Xm, Ms^Xm, Ms^Xm, Aa^Fda, Aa^Fpa, Aa^Fda, Aa^Fpa, Aa, Aa^Fda, Aa, Ms^Xm, Ms^Xm, Ms^Xm, Ms^Xm, Ms^Xm, Ms^Xm, Qxua, Qxua, Qxua, Qxua, Qxua, Qxua, Qxua
Qxua, Qxua, Qxua, Qxua, Qxua, Qxua, Qxua, Qxua, Qxua, Qxua, MdaZ, Qxua, MdaZ, Qxua, MdaZ, Qxua, MdaZ, MdaZ, MdaZ, MdaZ, MdaZ, MdaZ, MdaZ, MdaZ, MdaZ, Hhd, Xuc, Uu^Vud, Uu^Br\, Uu, Urb^Emf, Uu, Uu, Uu, Uu, Xuc, Xuc, Ms^Xm, Xuc, Ms^Xm, Aa, Ms^Xm, Aa, Aa, Aa, Ms^Xm, Rrc^VYmb, Aa^Fda, Aa^DYb, Aa^Fda, Aa, Aa, Aa, Aa, Aa, Aa, Aa, Aa^Voa, Aa, Aa, Aa, Ms^Xm, Ms^Xm, Qxua, Qxua, Qxua, Qxua, Qxua
Qxua, Qxua, Qxua, Qxua, Qxua, Qxua, Qxua, Qxua, MdaZ, MdaZ, Qlf, MdaZ, MdaZ, MdaZ, MdaZ, MdaZ, MdaZ, MdaZ, Hhd, MdaZ, Qlf, MdaZ, MdaZ, MdaZ, Hhd, Hhd, Hd, Uu^Vud, Uh, Uu^Br\, Uu^Br\, Uu, Uu, Uu, Uu, Uu, QxYi, Xuc, Aa^Fma, Aa^Fma, Aa^Fma, Aa^Fma, Uu, QxYi, QxYi, QxYi, Urb, Ha, Aa, Aa, Xom, Xom, Xom, UYi, QxYi, UYi, UYi, Aa, CtYa, CtYa, CtYa, Aa, Ha, Ms^Xm, Qxua, Qxua, Qxua, Qxua
Qxua, Qxua, Qxua, Qxua, Qxua, Qxua, MdaZ, MdaZ, MdaZ, Qlf, MdaZ, Qlf, MdaZ, Hhd, Hhd, MdaZ, Hhd^Dr, Hhd, Hhd, Hhd, Gd^Fts, Qlf, Hhd, Hhd, Hhd, Rd^Edpp, Rd, Xuc, Xuc, Uh, Xuc, Uu^Br\, Uu^Br\, Uu, Uu, Uu, Rb^Fdyu, QxYi, QxYi, QxYi, Uu, Uu, Uu, Uu, Cea, Uu, Uu, Ha, Ha, Xom, Xom, Xom, Xom, Xuc, XYui, QxYi, Aa, UYi, Aa, CtYa, 3 KtYa, CtYa, Ha, Ms^Xm, Qxua, Qxua, Qxua, Qxua
Qxua, Qxua, Qxua, Qxua, Qxua, MdaZ, MdaZ, Qlf, Qlf, MdaZ, Qlf, Qlf, Dd^Dr, Hhd, Hhd, Hhd, Hhd, MdaZ, Hhd^Dr, Gd^Fts, Dd^Emf, Qlf, Rd^Edpp, Hhd, Dd, Rd, Rd, Rd, Xue, Xuc, Xue, Xuc, Xuc, Uu^Br\, Uu^Br\, Uu, Rb^Fdyu, Uu, Uu, Rd, Rd, Rd, Uu, Rd, Uu, Cea, Uu, Uu, Xuc, Xuc, Xuc, Xom, UYi, UYi, UYi, UYi, Ha, Aa, Ha, CtYa, CtYa, CtYa, Ha, Ms^Xm, Qxua, Qxua, Qxua, Qxua
Qxua, Qxua, Qxua, Qxua, Qxua, MdaZ, Qlf, Qlf, Rd, Qlf, Dd^VdpY, Dd^Dr, Dd^Dc, Cd, 6 Kdr, Cd, Dd, Dd^Dc, Dd^Dr, Hhd, Hhd, Dd^Vdao, Rd, Rd^Ecf, Rd, Gd^Fts, Dd, Xue, Dd, Uu, Uu, Xue, Uu, Xuc, Xuc, Uu^Br\, Uu^Br\, Rb^Fdyu, Uu, Uu, Uu, Rb^Fdyu, Rb^Fdyu, Uu, Rd, Uu, Uu, Xuc, Uu^Vud, Uh, Xuc, Xuc, SpaY, UYi, QxYi, Ha, QxYi, Ha, Aa, Ha, UYi, Ha, UYi, UYi, Qxua, Qxua, Qxua, Qxua
Qxua, Qxua, Qxua, Qxua, Qxua, MdaZ, Qlf, Qlf, Rd^Edp, Dd^Dc, Dd, Dd^Dr, Dd, Cd, Cd, Cd, Dd^Dc, Rdc, Hhd, Dd^Dr, Gd^Fts, Dd^Sob, Dd, Dd^Do, Dd^Esd, Dd, Md, Uu, Uu, Dd, Dd, Uu, Dd^Emf, Uu, Uu, Xuc, Xuc, Uu^Br\, Uu^Br\, Uu, Uu, Uu, Rd, Rd, Rb^Fdyu, Uu, Xuc, Xuc, Uh, Uh, Uu^Br/, SpaY, SpaY, QxYi, Xuc, UYi, QxYi, Aa^FYak, Aa^FYak, UYi, Aa, UYi, Ha, Ha, Ha, Qxua, Qxua, Qxua
Qxua, Qxua, Qxua, Qxua, Qxua, MdaZ, MdaZ, Qlf, Qlf, Rd, Gd^Fts, Dd^Dc, Dd^Vdao, Dd^Dr, Dd, Dd^Dr, Dd, Rdc^Ecf, Dd^Dc, Gd^Fts, Gd^Fts, Dd, Dd, Dd^Esd, Rdc^Emf, Md, Md, Cud, Dd^Emf, Uu, Dd, Uu, Uu, Uu, Xue, Xue, Uu, Uu, Uu^Br/, Uu^Br\, Xuc, Uu, Uu, Uu, Rb^Fdyu, Uu, Xuc, Xuc, Uu^Br/, Uu^Br/, Urb, Uh, Uu^Vud, Xuc, Xuc, UYi, UYi, UYi, UYi, UYi, Aa, Aa, Ha, Ms^Xm, Qxua, Qxua, Qxua, Qxua
Qxua, Qxua, Qxua, Qxua, Qxua, Qxua, MdaZ, MdaZ, MdaZ, Qlf, Rd, Rd, Rd, Ds, Hhd, Dd^Dc, Dd^Do, Dd, Dd^Esd, Rdc^Emf, Dd, Rdc, Rdc, Gd^Fts, Gd^Fts, Rdc^Esd, Rdc^Ecf, Kud, Uu^Edpp, Uu, Uu, Dd^Edpp, Dd, Xue, Xue, Uu, Uu^Br/, Uu^Br/, Xuc, Xuc, Xuc, Uu^Br\, Uu^Br\, Rb^Fdyu, Uu, Xuc, Uu^Br/, Uu^Br/, Uu, Urb, Uu, Uu, Xuc, Xuc, Ha, Ha, UYi^XiS, Ha, Aa^XiS, QxYi, QxYi, Aa^Fpa, Ms^Xm, Qxua, Qxua, Qxua, Qxua, Qxua
Qxua, Qxua, Qxua, Qxua, Qxua, Qxua, Hhd, MdaZ, MdaZ, Qlf, Qlf, Rd, Rd, Dd^Dc, Hhd, Hhd, Gd^Fts, Dd, Qxua, Dd^VdpY, Dd, Dd^Edp, Dd, Rdc, Hhd, Rdc, Qxua, Qxua, Qxua, Uu, Xue, Dd, Rb^Fdyu, Uu, Uu^Br/, Uu^Br/, Uh, Xuc, Xuc, Xuc, Xuc, Xuc, Xuc, Uu^Br\, Uu^Br/, Uu^Br/, Uu, Uu, Uu, Uu, Xuc, Xuc, Ha, Xuc, UzwY, UzwY, UzwY, Aa^XiS, Ha, Aa, Aa^Fpa, Ms^Xm, Qxua, Qxua, Qxua, Qxua, Qxua, Qxua
Qxua, Qxua, Qxua, Qxua, Qxua, Qxua, MdaZ, MdaZ, MdaZ, Dd, Dd, Gd^Fts, Hhd, Gg, Gg, Dd, Hhd, Qxua, Qxua, Qxua, Qxua, Dd^Dc, Qxua, Qxua, Qxua, Qxua, Qxua, Qxua, Qxua, Qxua, Qxua, Uu, Rb^Fdyu, Ur, Ur, Uu, Uh, Uh, Ior, Xuc, Ior, Ior, Rb^Fdyu, Xuc, Xuc, Xuc, Xuc, Uu, Xuc, Xuc, Ha, Ha, Aa, UzwY, Aa, Aa, UzwY, Ha, Ha, Aa^Fpa, Ms^Xm, Ha, Qxua, Qxua, Qxua, Qxua, Qxua, Qxua
Qxua, Qxua, Qxua, Qxua, Qxua, Qxua, Qxua, MdaZ, Qxua, Dd, Hd, Dd, Dd, Hhd, Dd, Dd, Gll, Gll, Qxua, Qxua, Qxua, Qxua, Qxua, Qxua, Qxua, Qxua, Qxua, Qxua, Qxua, Qxua, Ior, Uu, Ur, Ur, Cer, Uu, Ior, Ur, Gd^FYok, Ur, Rb^Fdyu, Gd^FYok, Rb^Fdyu, Uu^Vud, Ior, Ior, Xoi, Xuc, Ha, Ha, Aa^Fda, Aa^Fda, UzwY, UzwY, Coa, Coa, UzwY, Aa, Aa, Aa^Fpa, Ha, Ms^Xm, Qxua, Qxua, Qxua, Qxua, Qxua, Qxua
Qxua, Qxua, Qxua, Qxua, Qxua, Qxua, Qxua, Qxua, Qxua, Qxua, Dd^Ftd, Dd^Edp, Gg, Md, Md, Md, Gll^Fmw, Gll^Fmw, Gll^Fmw, Aa^Fda, Gll^Fmw, Gll^Fmw, Gll^Fmw, Gll^Fmw, Hhd, Hhd, Hhd, Hhd, Gll^Fmf, Qxua, Rb^Fdyu, Uu, Ur, Cer, Ker, Cer, Cer, Rb^Fdyu, Ur, Rb^Fdyu, Ur, Rb^Fdyu, Icn, Ur, Ior, Ior, Xoi, Xoi, CtYa, Ha, Aa^Fda, UzwY, UzwY, Coa, Coa, Koa, UzwY, UzwY, Aa, Aa^Voa, Aa^FYak, Ms^Xm, Qxua, Qxua, Qxua, Qxua, Qxua, Qxua
Qxua, Qxua, Qxua, Qxua, Qxua, Qxua, Qxua, Qxua, Qxua, Qxua, Dd, Rdc, Dbyu, Dd^Ftd, Qxua, Gll, Qxua, Gll^Fmw, Gg, Gll^Fmw, Gll, Cud, Cud, Hhd, Qxu, Hhd, Hhd, Hhd, Gs^Ft, Ior, Ur, Ur, Ur, Cer, Cer, Cer, Rb^Fdyu, Uu, Ior, Ior, Icn, Icn, Icn, Icn, Icn, Xoi, Ior, Xoi, Xoi, Aa^Fda, UzwY, UzwY, UzwY, UzwY, UzwY, Coa, UzwY, Aa, UzwY, Aa^FYak, Aa^FYak, Ms^Xm, Ms^Xm, Qxua, Qxua, Qxua, Qxua, Qxua
Qxua, Qxua, Qxua, Qxua, Qxua, Qxua, Qxua, Qxua, Qxua, Rdc, Dbyu, Dd^Do, Dd, Qxua, Qxua, Qxua, Qxua, Qxua, Qxu^Bh/, Gll^Fmw, Gll^Fmw, Gll^Fmw, Gll^Fmw, Qxu, Qxu, Qxu, Gll^Fmf, Ior, Gg, Ior, Gs^Ft, Uu, Uu, Uu, Rb^Fdyu, Uu, Uu, Uu^Vud, Icn, Icn, Icn, Icn, Icn, Icn, Icn, Icn, Icn, Ior^Emf, Ior, Xoi, Cud, UzwY, UzwY, UzwY, Aa^Fda, UzwY, Aa^Fda, Aa^Fda, Aa^Fda, UzwY, UzwY, Aa^FYak, Ms^Xm, Qxua, Qxua, Qxua, Qxua, Qxua
Qxua, Qxua, Qxua, Qxua, Qxua, Qxua, Qxua, Qxua, Dbyu, Dbyu, Dd, Dbyu, Rdc, Qxua, Qxua, Qxua, Qxu^Bh/, Qxu^Bh/, Qxua, Qxua, Qxua, Gll^Fmw, Gll^Fdf, Gll^Fdf, Gll^Fdf, Gll^Fmf, Gll^Fdf, Ior, Ior, Ior, Uu^Vud, Uu, Uu, Uh, Uu^Vud, Uu, Icn, Icn, Icn, Icn, Icn, Icn, Uh, Iwr, Rb^Fdyu, Icn, Icn, Icn, Icn, Ior, Kud, Cud, Xoc, Aa^Fda, Ha, Ha, Xoi, Xoi, Xoi, Aa, Ha, Urb, Aa^FYak, Qxua, Qxua, Qxua, Qxua, Qxua
Qxua, Qxua, Qxua, Qxua, Qxua, Qxua, Qxua, Dbyu, Mm^Xm, Mm^Xm, Mm^Xm, Dbyu, BrYm, Qxua, Qxu^Bh/, Qxu^Bh/, Qxua, Qxua, Qxua, Qxua, Qxua, Qxua, Qxua, Qxu, Qxu, Gll^Fdf, Qxua, Gll^Fdf, Gll^Fmf, Ior, Uh, Uu, Ior, Uh, Icn, Icn, Icn, Icn, Icn^Emf, Icn, Ur, Iwr, Uh, Gd^FYok, Uh, Iwr, Iwr, Icn, Icn, Icn, Icn, Xoc, Xoc, Xoc, Xoc, Xoi, Xoc, Xoc, Xoc, Xoi, Ha, Urb, Aa, Qxua, Qxua, Qxua, Qxua, Qxua
Qxua, Qxua, Qxua, Qxua, Qxua, Qxua, Rr^Vd, Mm^Xm, QxvY, Rr^Vd, QxvY, WwbY, BrYm, BrYm, BrYm, Qxua, Qxua, Qxua, Qxua, Qxua, Qxua, Qxua, Qxua, Qxua, Qxua, Qxua, Qxua, Qxua, Ior, Ior, Uh, Uh, Icn, Icn, Icn, Icn, Icn, Icn, Qxua, Ior, Ur, Ur, Ur, Ur, Qxua, Qxua, Iwr, Iwr, Rb^Fdyu, Icn, Icn, Icn, Icn, Xoc, Xoc, Xoc, Ior, Xoc, Ior, Xoc, Xoc, Urb, WYwb, Qxua, Qxua, Qxua, Qxua, Qxua
Qxua, Qxua, Qxua, Qxua, Qxua, Qxua, Mm^Xm, QxvY, QxvY, QxvY, Cer, Cer, UheY, UheY, UheY, Qxua^FYb\, Qxua^FYb\, Qxua, Qxua, Qxua, Iwr, Ior, Ior, Qxua, Ior, Qxua, Qxua, Qxua, Qxua, Ior, Icn^Emf, Icn, Icn, Icn, Icn, Icn, Ur, Ur, Uu^Vud, Ur, Xoc, Uu^Vud, Xoc, Ur, Iwr, Iwr, Uh, Uh, Rb^Fdyu, Iwr, Icn, Icn, Icn, Icn, Icn, Ior, Ior, Ior, Ior, Xoc, Xoc, Aa, Urb, Cud, Qxua, Qxua, Qxua, Qxua
Qxua, Qxua, Qxua, Qxua, Qxua, Qxua, Mm^Xm, QxvY, Cer, Cer, 4 Ker, Cer, Cer, UheY, UheY, Qxua, Qxua, Qxua^FYb\, Qxua^FYb\, Qxua, Ior, Xoi, Xoi, Ior, Xoi, Ior, Iwr, Qxua, Icn, Icn, Icn, Icn, Icn, Icn, Ur, Uh, Uh, Uh, Xoc, Xoc, Xoc, Xoc, Rrc^VYmb, Xoc, Xoc, Xoc, Xoc, Xoc, Icn, Icn, Icn, Icn, Icn, Icn, Xoc, Ior, Ior, Ior, Ior, Ior, Xoc, Aa, Urb, Cud, Qxua, Qxua, Qxua, Qxua
Qxua, Qxua, Qxua, Qxua, Qxua, Qxua, QxvY, QxvY, Ql, Cer, Cer, Cer, UheY, UheY, UheY, Qxua, Qxua, Rrc^BrYb, Qxua, Qxua^FYb\, Iwr, Xoi, Xoi, Xoi, Kud, Iwr, Icn, Icn, Icn, Icn, Icn, Icn, Qxua, Iwr, Ur, Uh, Xoc, Xoc, Xoc^Efs, Xoc, Ior, Ior, Uu^Uf, Ior, Ior, Ior, Icn, Icn, Icn, Icn, Icn, Icn, Uu^Uf, Uh, Uu^Vud, Xoc, Ior, Ior, Ior, Ior, Xoc, Urb, Ha, Qxua, Qxua, Qxua, Qxua, Qxua
Qxua, Qxua, Qxua, Qxua, Qxua, Qxua, Mm^Xm, Ql, Ql, BrYm, UheY, UheY, UheY, UheY, Qxu^XiS, Qxu^XiS, MYb, Qxua, Qxua^FYb/, Qxua^FYb/, Qxua, Qxua, Xoi, Cud, Icn, Icn, Icn, Icn, Icn, Icn, Iwr, Iwr, Ur, Ur, Xoi, Xoc, Xoc, Xoc^Efs, Ior, Ior, Ior, Rb, Ior, Qxua, Icn, Icn, Icn, Icn, Icn, Icn^Emf, Ior, Gd^FYok, Qxua, Uh, Xoi, Xoc, Xoc, Ior, Xoi, Xoi, Xoc, Urb, Ha, Aa^FYak, Qxua, Qxua, Qxua, Qxua
Qxua, Qxua, Qxua, Qxua, Qxua, Mm^Xm, Rr^Vd, Ql, Ql, BrYm, UheY, UheY, Qxua, Qxu^XiS, Qxu, MYb^VmyT, MYb, MYb, Qxua, Qxua, Qxua, Rrc^BrYb, Icn, Icn, Icn, Icn, Kud, Icn, Iwr, Iwr, Iwr, Iwr, Xoc, Xoi, Uu^Vud, Xoc, Ch, Ior, Xoi, Ior, Iwr^TabY, Ior, Icn, Icn, Icn, Icn, Icn, Icn, Qxua, Ior, Ior, Uh, Xoc, Xoi, Xoc^Efs, Xoc^Efs, Uu^Vud, Xoi, Xoc, Xoc, Urb, Urb, WYwb, Aa, Qxua, Qxua, Qxua, Qxua
Qxua, Qxua, Qxua, Qxua, Qxua, Mm^Xm, Mm^Xm, Ql, Ql, BrYm, UheY, Qxua, Qxua, Qxu^XiS, Qxu^XiS, Qxua^XiS, Qxua, Qxua, Qxua, Rrc^BrYb, Icn, Icn, Icn, Icn, Icn, Cud, Xoi, Xoi, Xoi, Iwr, Xoc, Iwr, Ior, Cud, Cud, Cud, CdwY, Xoi, Xoc, Xoi, Xoc, Icn, Icn, Icn, Icn, Icn, CtrY, Ior, CtrY, CtrY, Xoc, Xoc, Xoc^Efs, Xoc, Ior, Ior, Uh, Xoi, Xoi, Xoc, Urb^Edb, Urb^Edb, WYwb, Qxua, Qxua, Qxua, Qxua, Qxua
Qxua, Qxua, Qxua, Qxua, Qxua, Mm^Xm, Mm^Xm, Mm^Xm, BrYm, BrYm, UheY, Qxua, Qxua, Qxu^XiS, Qxu^XiS, Qxua, Qxua, Rrc^BrYb, Icn, Icn, Icn, Icn, Icn, Icn, Rrc^BrYb, UheY, Xoi, Xoi, Xoi, Xoc, Cud, Cud, Ior, Ior, Ior, Icn, CdwY, KdwY, CdwY, Xoi, Xoc, Icn, Icn, Icn, Ior, Ior, CtrY, CtrY, CtrY, KtrY, CtrY, Ior, Ior, Ior, Ior, Ior, Xoi, Xoi, CydY, Urb^Edb, WYwb, WYwb, WYwb^Edb, WYwb, Qxua, Qxua, Qxua, Qxua
Qxua, Qxua, Qxua, Qxua, Qxua, Qlf, Qlf, BrYm, BrYm, UheY, UheY, UheY, Qxu^XiS, Qxu^XiS, Qxu, Rrc^BrYb, Icn, Icn, Icn, Icn, Icn, Icn, Rrc^BrYb, Qxua, Qxua, UheY, UheY, Xoi, Xoc, Uu^Vud, Cud, Cud, Ior, Ior^Emf, Ior, Icn, Icn, CdwY, 1 KdwY, CdwY, CdwY, Xoi, Icn, Icn, Iwr, Uh, WuoZ, CtrY, CtrY, CtrY, CtrY, Uh, Ior, Ior, Xoi, Xoi, KydY, KydY, CydY, WYwb^Edb, WYwb^Edb, WYwb, WYwb^Edb, WYwb, Qxua, Qxua, Qxua, Qxua
Qxua, Qxua, Qxua, Qxua, Qlf, Qlf, Qlf, Qlf, Qxua, CtrY, CtrY, Qxua^XiS, Qxu^XiS, Rrc^BrYb, Icn, Icn, Icn, Icn, Icn, Icn, Rrc^BrYb, Qxua, Qxua, Qxua, Qxua, Qxua, Qxua, UheY, UheY, Cud, Cud, Ior, Ior, Ior, Qxua, Ior, Icn, CdwY, CdwY, CdwY, CdwY, CdwY, Icn, Icn, Iwr, WuoZ, Wo, Wo, Ss, CtrY, CtrY, Xoi, Xoc, Xoi, Xoc, Xoi, CydY, CydY, CydY, WYwb^Edb, WYwb, WYwb, WYwb, Qxua, Qxua, Qxua, Qxua, Qxua
Qxua, Qxua, Qxua, Qxua, Qlf, Qlf, Qxua, Qxua, Qxua, Qxua, Gll^Ftr, CtrY, Icn, Icn, Icn, Icn, Icn, Icn, Rrc^BrYb, Qxua, Qxua, Qxua, Qxua, Qxua, Qxua, Qxua, Qxua, UheY, UheY, Xoc, Xoc, Uu^Vud, Xoc, Ior, Ior, Ior, Ior, Icn, Icn, Icn, Icn, Icn, Iwr, Rb, Uu^Uf, Ww^Vm, Wo, WuoZ, Wo, CtrY, IcP, Xoi, Xoi, Xoc, Xue, Xue, CydY, CydY^Edb, CydY, WYwb^Edb, WYwb, WYwb^Dr, WYwb, Qxua, Qxua, Qxua, Qxua, Qxua
Qxua, Qxua, Qxua, Qxua, Qlf, Qlf, Qxua, Qxua, Gll^Ftr, Gll^Ftr, Urc, Iwr, Icn, Icn, Icn, Icn, Rrc^BrYb, Qxua, Qxua, Qxua, Qxua, Qxua, Qxua, Rrc^BrYb, Qxua, Qxua, Qxua, Qxua, Qxua, UheY, UheY, Xoc, Xoc, Ch, Ior, Qxua, Ior, Ior, Uu^Uf, Ior, Rb^Fdyu, Iwr, Iwr, Rb, Xoc, Iwr, Iwr, Wo, Wo, Wo, WuoZ, IcP, IcP, Xoi, Rb^Fdyu, Urb^Efs, Urb, CydY, WYwb^Edb, WYwb, WYwb, WYwb, WYwb^Edb, WYwb, Qxua, Qxua, Qxua, Qxua
Qxua, Qxua, Qxua, Qxua, Qlf, Qxua, Hh, Gg, Gll^Ftr, Gll^Ftr, Urc, Iwr, Iwr, Iwr, Gll^Ftr, Qxua, Qxua, Qxua, Qxua, Qxua, Qxua, Qxua, Qxua, Qxua, Qxua, Qxua, Qxua, Qxua, Qxua, Qxua, Rrc^BrYb, UheY, Ior, Ior, Qxua, Ior, Ch, Ior, Ior, Qxua, Ior^Emf, Ior, Ior, Xoc, Xoc, Xoc, Iwr, WuoZ, Wo, Wo, Wo, IcP, Xue, Urb^Efs, Urb^Efs, Urb^Edb, WYwb^Edb, WYwb^Edb, WYwb^Dr, WYwb, WYwb^Edb, WYwb^Dr, WYwb^Edb, WYwb, Qxua, Qxua, Qxua, Qxua
Qxua, Qxua, Qxua, Qxua, Qxua, Qxua, Hh, Gll^Ftr, Gll^VftH, Urc, Urc, Iwr, Iwr, Gll^Ftr, Urc, Gll^Ftr, Gll^Ftr, Qxua, Qxua, Qxua, Qxua, Qxua, Qxua, Qxua, Qxua, Qxua, Qxua, Qxua, Qxua, Qxua, Qxua, Qxua, Ior, Ior, Qxua^BaB/, Qxua, Xoc, Ior, Xoc, Ior, Ior, Qxua, Ior, Ior, Ior, Xoc, Xoc, Iwr, Wo, Wo, Wo, Ss, Xue, Xue, Urb^Efs, Rb^Fdyu, WYwb^Edb, WYwb^Edb, WYwb, WYwb^Edb, WYwb, WYwb^Edb, WYwb, Qxua, Qxua, Qxua, Qxua, Qxua
Qxua, Qxua, Qxua, Qxua, Qxua, Hh, Gg, Gll^Ftr, Gll^VftH, Urc, Urc, Urc, Iwr, Urc, Urc, Gg, Qxua, Gll^Ftr, Qxua, Qxua, Qxua, Qxua, Qxua, Qxua, Qxua, Qxua, Qxua, Qxua, Qxua, Qxua, Qxua, Qxua, Qxua^BaB/, Qxua^BaB/, Rrc^BrYb, Ior, Xoc, Xoc, Xoc, Ior, Xoc, Ior, Xoc, Ior, Ior, Ior, Xoc, Iwr, WuoZ, Wo, WuoZ, Xoi^Efs, Xue, Xue, Urb^Efs, Gll^Dr, WYwb, WYwb, WYwb, WYwb^Edb, WYwb^Dr, WYwb, WYwb, Qxua, Qxua, Qxua, Qxua, Qxua
Qxua, Qxua, Qxua, Qxua, Qxua, Gs^Fto, Gs^Fto, Gll^Ftr, Gll^Ftr, Urc, Urc, Urc, Urc, Urc, Urc, Qxua, Gll^Ftr, Qxua, Gs^Fto, Qxua, Qxua, Qxua, Qxua, Qxua, Qxua, Qxua, Qxua, Qxua, Qxua, Qxua, Qxua^BaB/, Qxua^BaB/, Qxua, Qxua, Qxua, Gll^Ftr, Mm, Xoc, Rr^FgcX, Xoc, Uu^Vud, Xoc, Rr^FgcX, Xoc, Xoc, Xoc, Iwr, Iwr, Iwr, WuoZ, WuoZ, Xue, Xue, Urb^Efs, Urb^Efs, WYwb^Edb, WYwb, WYwb^Edb, WYwb, WYwb^Dr, WYwb, Wog, Wog, WYwb^Edb, Wog, Qxua, Qxua, Qxua
Qxua, Qxua, Qxua, Qxua, Mm, Qxua, Gg, Gs^Fto, Hh, Gg, Ww^Ewl, Urc, CtY, CtY, CtY, Urc, Urc, Gll^Ftr, Hh, Gs^Fto, Qxua, Qxua, Qxua, Gll^Ftr, Gll^Ftr, Qxua, Ss^SsmG, Ur, Ss^BaB/, Qxua^BaB/, Qxua, Qxua, Qxua, Qxua, Qxua, Qxua, Gll^Ftr, Ur, Rr^FgcX, Rr^FgcX, Rr^FgcX, Rr^FgcX, Ior, Rr^FgcX, Ior, Xoc, Iwr, Iwr, WuoZ, WuoZ, Ss, Ss, Xue, Xue, Urb^Efs, WYwb^Edb, WYwb, Wog, Wog, WYwb, WYwb, Wog, Wog, Wog, Wog, WYwb, WYwb, Qxua
Qxua, Qxua, Qxua, Qxua, Gll^Fp, Qxua, Gg, Gs^Fto, Hh, Gll^Ftr, Gg, Urc, Urc, CtY, KtY, Urc, Urc, Gg, Hh, Gs^Fto, Qxua, Mm, Qxua, Gll^VftH, Gll^Ftr, Ss^SsmG, Gll^Ftr, Ur, Ur, Uu^Ufi, Ss^SsmG, Qxua, Qxua, Qxua, Qxua, Qxua, Gll^Ftr, Xoc, Xoc, Rr^FgcX, Ior, Rr^FYrf, Ior, Ior, Ior, Xoc, Iwr, Iwr, Iwr, WuoZ, Ss, Ss, Ss, Rb^Fdyu, Urb^Efs, Rb^Fdyu, Ss^Vhso, Wog^Dr, WYwb, Wog, Wo, WYwb^Edb, Wog, WYwb, Wo, Qxua, Wo^Vwss, Qxua
Qxua, Qxua, Qxua, Mm, Gll^Fp, Qxua, Qxua, Gs^Fto, Gs^Fto, Gll^Ftr, Gg, Urc, Urc, CtY, CtY, CtY, Urc^Em, Gg^Epen, Hh, Gll^Ftr, Qxua, Qxua, Gll^Ftr, Gll^Ftr, Gll^Ftr, Gll^Fp, Gg^Edb, Gg^FfyZ, Ss^SsmG, Ss^SsmG, Gll^VftH, Ss^SsmG, Qxua, Qxua, Gll^Ftr, Gll^Ftr, Xue, Xoc, Xoc, Xoc, Ior, Ior, Ior, Ior, Iwr, Iwr, Iwr, Iwr, Xoc, Xoc, Xoc, Ss, Ss, Ss, Ss, Ss, Ss, Wo, Wo, Wog, WYwb, Wo, Wo, WYwb, Wo, Qxua, Qxua, Qxua
Qxua, Qxua, Qxua, Gll^Fp, Mm, Gll^Fp, Qxua, Gg, Gs^Fto, Hh, Hh, Gll^Ftr, Urc, CtY, Urc, Urc, Ww^Ewl, Gg, Hh, Qxua, Gg^Emon, Qxua, Gll^Ftr, Gll^Fp, Gg^Edb, Gg^Edb, Gg^Edb, Gg^Edb, Ss^SsmG, Ss^Bw\, Ss^Bw\, Mm, WobY^Bw/, WobY^Bw/, Gll^Ftr, Gll^Ftr, Gd^FYok, Xue, Xue, Xue, Xue, Xoc, Xoc, Ior, Xoc, Iwr, Xoc, Xoc, Xue, Xoc, Xue, Xue, Urb, Ss, Urb^Efs, WYwb^Edb, WYwb, WYwb^Edb, WYwb, WYwb^Edb, WYwb^Dr, WYwb, Wo, WYwb, Qxua, Qxua, Qxua, Qxua
Qxua, Qxua, Qxua, Qxua, Mm, Gs^Fto, Gs^Fto, Qxua, Qxua, Gs^Fto, Gll^Fp, Hh, Gll^Ftr, Urc^Em, Urc, Gg, Gll^Fp, Gll^Fp, Gs^Fto, Qxua, Qxua, Qxua, Gll^Ftr, Gg^Edb, CvzY, CvzY, CvzY, Gg^Edb, Ss^SsmG, Ss^SsmG, Qxua, WobY^Bw/, Qxua, Qxua, Gd^Fetd, Uu^FfyZ, Uu^Uf, Uu^Emf, Urb^Edb, Uu^Emf, Gd^FfyZ, Xue, Xue, Xue, Xue, Xue, Xue, Xue, Xue, Xue, Xue, Urb, Urb^Efs, Urb^Efs, WYwb, Rb^Fdyu, Urb, Urb, Urb, WYwb^Edb, WYwb, Wo, Wo, Wo, Qxua, Qxua, Qxua, Qxua
Qxua, Qxua, Qxua, Qxua, Qxua, Gg, Gg, Gll^Fp, Gll^Fp, Qxua, Qxua, Gll^Fp, Gll^Fp, Gg, Qxua, Gg^Gvs, Gg, Gs^Fto, Gs^Fto, Qxua, Qxua, Gll^Ftr, Gll^Fp, Gg^Edb, CvzY, 2 Kv, CvzY, Gg^FfyZ, Qxua, Qxua, Qxua, Qxua, Qxua, Gs^Ft, Urb, Uu^Uf, Uu^Uf, Urb^Wm, Urb^Edb, Uu^Emf, Xue, Rr^Vhc, Urb^Edb, Xue, Rb^Fdyu, Rb^Fdyu, Urb^Edb, Rb^Fdyu, Urb^Edb, Xue, Urb^Efs, Urb^Efs, CdwY, CdwY, Wo^Edb, WYwb, WYwb^Edb, Urb, WYwb^Edb, Wo^Edb, Wo^Edb, Wo, Wo, Qxua, Qxua, Qxua, Qxua, Qxua
Qxua, Qxua, Qxua, Qxua, Qxua, Mm, Mm, Gll^Fp, Gll^Fp, Gs^Fto, Gs^Fto, Qxua, Gs^Fto, Qxua, Gs^Fto, Qxua, Qxua, Qxua, Gll^Ftr, Gs^Fto, Gll^VftH, Gll^Ftr, Hh, Gg^Edb, Gs^Fms, CvzY, Gs^Fto, Gs^Fto, Qxe, Qxe, Qxe, Qxua, Gd^Fetd, Gs^Ft, Urb, Rb^Fdyu, Rb^Fdyu, Xu, Uu^Edb, Uu^Edb, Xue, Xue, CydY, Urb^Edb, Urb^Edb, Urb^Edb, Urb^Efs, Urb^Edb, Urb^Efs, Urb^Efs, Urb^Efs, Urb, WYwb, WYwb^Edb, Wo^Edb, Wo, Wo, WYwb^Edb, WYwb^Edb, Wo^Edb, Wo, Wo, WuoZ, Qxua, Qxua, Qxua, ZaW, Qxua
Qxua, Qxua, Qxua, Qxua, Qxua, Qxua, Mm, Uh, Mm, Gll^Fp, Gll^Fp, Gs^Fto, Hh, Hh, Hh, Hh, Hh, Gll^Ftr, Gs^Fto, Gll^Ftr, Gll^Ftr, Gll^Ftr, Gg^FfyZ, Hh, Gg^Edb, Gs^FfyZ, Gd^Fetd, Gs^FfyZ, Qxe, Mdd^Xm, Qxe, Qxua, Rb^Fdyu, Rb^Fdyu, Uu^FfyZ, Rb^Fdyu, Rb^Fdyu, Xu, Rr^Vhc, Uu^Edb, Xue, 5 KydY, CydY, CydY, Urb^Efs, Urb^Efs, Urb, WYwb^Efs, WYwb^Erf, WYwb^Efs, WYwb^Erf, WYwb^Erf, Xue, Wo^Edb, Wo, Wo, Wo, Wo, Wo^Dr, Wo, Wog, Wo, WuoZ, WuoZ, Qxua, WuwZ, ZaW, Qxua
Qxua, Qxua, Qxua, Qxua, Qxua, Qxua, Qxua, Mm, Qxua, Mm, Mm, Hh, Hh, Gs^Fto, Qxua, Qxua, Qxua, Qxua, Qxua, Gs^Fto, Qxua, Gs^Fto, Gs^Fto, Hh, Gs^Fto, Qxua, Gs^FfyZ, Gs^Fto, Gd^Fetd, Qxe, Gd^Fetd, Gs^Ft, Rb^Fdyu, Gd^FfyZ, Uu^FfyZ, Xu^FfyZ, Rb^Fdyu, Gs^Fto, Uu^Edb, Xue, Xue, CydY, CydY, Urb^Edb, Urb^Edb, Rb^Fdyu, WYwb^Erf, WYwb^Erf, Xue, Xue, Xue, Xue, Ss^Vhso, Wo^Edb, Wo^Edb, Wo, Wo, Wo, Wog, Wog, Wog, WuoZ, Wog, Qxua, Qxua, WuwZ, WuwZ, Qxua
Qxua, Qxua, Qxua, Qxua, Qxua, Qxua, Qxua, Qxua, Qxua, Qxua, Qxua, Mm, Qxua, Hh, Gs^Fto, Gs^Fto, Gg, Gg, Gs^Fto, Qxua, Qxua, Qxua, Qxua, Gll^VftH, Gg^Edb, Qxua, Qxua, Ms^Xm, Qxua, Gg, Qxua, Ms^Xm, Rb^Fdyu, Gs^Fto, Uu^FfyZ, Uu^FfyZ, Rb^Fdyu, Urb, Uu^Edb, Uu^Edb, Uu^Edb, Uu^Edb, Uu^Edb, Urb^Edb, Urb^Edb, Rb^Fdyu, WYwb^Erf, Xue, WYwb, Xue, Wo, Wo, Wo, Wo, Wo, Wo, Wo, Wog, Wog, Wog, Wog, WuoZ, Wog, Qxua, Qxua, WuwZ, Qxua, Qxua
Qxua, Qxua, Qxua, Qxua, Qxua, Qxua, Qxua, Qxua, Qxua, Qxua, Qxua, Qxua, Qxua, Qxua, Qxua, Mm, Qxua, Hh, Hh, Hh, Mm, Hh, Hh, Qxua, Qxua, Gg^Edb, Qxua, Qxua, Mm, Qxua, Hh, Gs^Ft, Gs^Ft, Rb^Fdyu, Urb^Edb, Uu^FfyZ, Gs^Ft, Urb, Gs^Ft, Uu^Edb, Rr^Vhc, Uu^Edb, Urb^Edb, Urb^Edb, QxvY, Xue, QxvY, WYwb, WYwb, WYwb^Erf, Wo, Wog, Wo, Wog, Wo, Wo, Wo, Wog, WuoZ, Wog, WuoZ, Wog, Qxua, Qxua, Qxua, Qxua, Qxua, Qxua
Qxua, Qxua, Qxua, Qxua, Qxua, Qxua, Qxua, Qxua, Qxua, Qxua, Qxua, Qxua, Qxua, Qxua, Qxua, Qxua, Qxua, Qxua, Qxua, Mm, Qxua, Mm, Qxua, Mm, WobY, Qxua, WobY, Qxua, Qxua, Qxe, Qxua, Qxua, Qxua, Gs^Ft, Rb^Fdyu, Urb^Edb, Rb^Fdyu, Xue, Gs^Ft, Xue, Xue, Xue, Xue, Xue, Qxua, QxvY, Qxua, Gg, Qxua, Wo, Qxua, Wo, Qxua, Wo, Qxua, Qxua, Qxua, Wog, Wog, Wog, Wog, Wog, Qxua, Qxua, Qxua, Qxua, Qxua, Qxua
Qxua, Qxua, Qxua, Qxua, Qxua, Qxua, Qxua, Qxua, Qxua, Qxua, Qxua, Qxua, Qxua, Qxua, Qxua, Qxua, Qxua, Qxua, Qxua, Qxua, Qxua, Qxua, Qxua, Qxua, Qxua, Qxua, Qxua, Qxua, Qxua, Qxua, Qxua, Qxua, Qxua, Qxua, Qxua, Rb^Fdyu, Rb^Fdyu, Rb^Fdyu, Qxua, Qxua, Qxua, Qxua, Qxua, Xue, Qxua, Qxua, Qxua, Gg, Qxua, Qxua, Qxua, Qxua, Qxua, Qxua, Qxua, Qxua, Qxua, Wog, Qxua, Qxua, Qxua, Qxua, WuwZ, Qxua, Qxua, Qxua, Qxua, Qxua
Qxua, Qxua, Qxua, Qxua, Qxua, Qxua, Qxua, Qxua, Qxua, Qxua, Qxua, Qxua, Qxua, Qxua, Qxua, Qxua, Qxua, Qxua, Qxua, Qxua, Qxua, Qxua, Qxua, Qxua, Qxua, Qxua, Qxua, Qxua, Qxua, Qxua, Qxua, Qxua, Qxua, Qxua, Qxua, Qxua, Qxua, Qxua, Qxua, Qxua, Qxua, Qxua, Qxua, Qxua, Qxua, Qxua, Qxua, Qxua, Qxua, Qxua, Qxua, Qxua, Qxua, Qxua, Qxua, Qxua, Qxua, Qxua, Qxua, Qxua, Qxua, Qxua, Qxua, Qxua, Qxua, Qxua, Qxua, Qxua
Qxua, Qxua, Qxua, Qxua, Qxua, Qxua, Qxua, Qxua, Qxua, Qxua, Qxua, Qxua, Qxua, Qxua, Qxua, Qxua, Qxua, Qxua, Qxua, Qxua, Qxua, Qxua, Qxua, Qxua, Qxua, Qxua, Qxua, Qxua, Qxua, Qxua, Qxua, Qxua, Qxua, Qxua, Qxua, Qxua, Qxua, Qxua, Qxua, Qxua, Qxua, Qxua, Qxua, Qxua, Qxua, Qxua, Qxua, Qxua, Qxua, Qxua, Qxua, Qxua, Qxua, Qxua, Qxua, Qxua, Qxua, Qxua, Qxua, Qxua, Qxua, Qxua, Qxua, Qxua, Qxua, Qxua, Qxua, Qxua
Qxua, Qxua, Qxua, Qxua, Qxua, Qxua, Qxua, Qxua, Qxua, Qxua, Qxua, Qxua, Qxua, Qxua, Qxua, Qxua, Qxua, Qxua, Qxua, Qxua, Qxua, Qxua, Qxua, Qxua, Qxua, Qxua, Qxua, Qxua, Qxua, Qxua, Qxua, Qxua, WobY, Qxua, Qxua, Qxua, Qxua, Qxua, Qxua, Qxua, Qxua, Qxua, Qxua, Qxua, Qxua, Qxua, Qxua, Qxua, Qxua, Qxua, Qxua, Qxua, Qxua, Qxua, Qxua, Qxua, Xv, Qxua, Qxua, Qxua, Qxua, Qxua, Qxua, Qxua, Qxua, Qxua, Qxua, Qxua
