Qxua, Qxua, Qxua, Qxua, Qxua, Qxua, Qxua, Qxua, Qxua, Qxua, Qxua, Qxua, Qxua, Qxua, Qxua, Qxua, Qxua, Qxua, Qxua, Qxua, Qxua, Qxua, Qxua, Qxua, Qxua, Qxua, Qxua, Qxua, Qxua, Qxua, Qxua, Qxua, Qxua, Gg
Qxua, Qxua, Qxua, Qxua, Qxua, Qxua, Qxua, Qxua, Qxua, Qxua, Qxua, Qxua, Qxua, Qxua, Gs^Fto, Qxua, Qxua, Qxua, Qxua, Qxua, Rb^Fdyu, Qxua, Qxua, Qxua, Ha, Qxua, Qxua, Qxua, Qxua, Qxua, Qxua, Qxua, Qxua, Qxua
Qxua, Qxua, Qxua, Qxua, Qxua, Qxua, Qxua, Qxua, Qxua, Qxua, Dd^Ftd, Hhd^Vhhr, Rrc, Dd^Ftd, Rrc, Gs^Fto, Rrc, Qxua, Rrc, Rb^Fdyu, Rrc, Rb^Fdyu, Rrc, Aa^Vla, Aa, Ha, Aa^Fma, Qxua, Qxua, Qxua, Qxua, Qxua, Qxua, Qxua
Qxua, Qxua, Qxua, Qxua, Qxua, Qxua, Qxua, Qxua, Qxua, Dd^Ftd, Rrc, Rrc, Hd, Rrc, Hd, Rrc, Gs^Fds, Rrc, Gs^Fds, Rrc, Ha, Rrc, Gll, Rrc, Rrc, Aa^Fma, Aa^Fma, Qxua, Qxua, Qxua, Qxua, Qxua, Qxua, Qxua
Qxua, Qxua, Qxua, Qxua, MdsY, Hd, Rd, Qxua, Qlf^Bw/, Rrc, Hd, Hhd^Vhhr, Qxua, Hd, MdsY, Urb, Gs^Fds, Rrc^Edb, Gs^Fds, Urb, Ms^Xm, Ha, Qxua, Aa^Vla, Ha, Rrc, Qlf^Bw\, Qxua, Qxua, Qxua, Qxua, Qxua, Qxua, Qxua
Qxua, Qxua, MdsY, MdsY, MdsY, Rd, Re, Qlf^Bw/, Qlf, Qlf, Qxua, Qxua, Qxua, Qxua, MdsY, Urb, Gg^Edb, Rrc^Edb, Gg^Edb, Urb, Ms^Xm, Qxua, Qxua, Qxua, Qxua, Qlf, Qlf, Qlf^Bw\, Rrc, Ha, Ha, Qxua, Qxua, Qxua
Qxua, Qxua, MdsY, MdsY, Rd^Edpp, Rd, Ds^Edpp, MdsY, Qxua, Qxua, Qxua, Qxua, MdsY, MdsY, Xuc, Xuc, Wo^Edb, Rrc^Edb, Wo^Edb, Xuc, Xuc, Ms^Xm, Ms^Xm, Qxua, Qxua, Qxua, Qxua, Aa^Es, Rrc, Aa, Ha, Ms^Xm, Qxua, Qxua
Qxua, Qxua, MdsY, MdsY^Edpp, Ds, Re, Dd^Vda, Ds, Hd^Edpp, Qxua, Dd^Vdr, Rrc^BrYb, Xos, Xuc, Gs^Edb, Ss^Edb, Gll^VftH, Rrc^Edb, Gll^VftH, Wo^Edb, Hhd^Edb, Xuc, Xos, Rrc^BrYl, Rp^Vhcr, Qxua, Ha, Aa^Es, Rp^Vhcr, Rrc, Aa^Es, Ms^Es, Ms^Xm, Qxua
Qxua, Qxua, MdsY, Ds^Edpp, Cdr, Cdr, Cdr, Mm, Rp, Ds^Edp, Dd^Ftd, Hd^Edp, Ds^Edp, Hh, Gg^Edb, Ss^Edb, CydY, CydY, CydY, WYwb, Rrc^Edb, Rb^Fdyu, Gll^Edb, Ha, Aa^Fpa, Aa^Es, Rrc^Es, Ms, Ket, Ket, Ket, Aa^Es, Ms^Xm, Qxua
Qxua, Qxua, MdsY, Ds, Cdr, 1 Kdr, Cdr, Rp, Rp^Edpp, Rp, Rp, Rp, Rp, Rp, Rp, Rp, CydY, KydY^Ecf, CydY, Rrc^Edb, Gll^Edb, Rrc, Rrc^Edb, Rrc, Rrc, Rrc, Aa^Es, Rrc, Ket, 2 Ker, Ket, Aa^Es, Ms^Xm, Qxua
Qxua, Qxua, MdsY, Ds, Ds, Cdr, Dd^Vda, Mm, Dd^Ftd, Ds^Edp, Dd^Vdr, Ds^Edp, Xos, Gs^Fto, Hh^Edb, WYwb, Gll^VftH, CydY, Gll^VftH, WYwb, Gll^Edb, Uh, Xos, Aa^Em, Rp^Vhcr, Ha^Es, Aa^Es, Ms^Es, Rp^Vhcr, Ket, Aa^Es, Aa^Es, Ms^Xm, Ms^Xm
Qxua, Qxua, MdsY, MdsY, Rd^Edpp, Ds, MdsY, Hd, Qxua, Hd^Edp, Qxua, Rrc^BrYb, MdsY, Xuc, Xuc, Ss^Edb, Ss^Edb, Rrc^Edb, WYwb, Wo^Edb, Xuc, Xuc, Ms^Xm, Rrc^BrYl, Qxua, Ha^Es, Qxua, Aa^Es, Ha^Es, Aa^Es, Aa^Es, Ms^Es, Ms^Xm, Ms^Xm
Qxua, Qxua, MdsY, MdsY, MdsY, Ds, Ds^Edpp, Qxua, Qxua, Qxua, Qxua, Qxua, Qxua, MdsY, MdsY, Xuc, Gg^Edb, Rrc^Edb, Gg^Em, Xuc, Ms^Xm, Ms^Xm, Qxua, Qxua, Qxua, Qxua, Qxua, Qxua, Aa, Aa^Es, Aa^Fma, Ha, Ha, Qxua
Qxua, Qxua, Qxua, MdsY, MdsY, Hd, Ds, Dd^Ftd, Qlf, Qxua, Qxua, Qxua, Qxua, Qxua, MdsY, Urb, Gs^Fds, Rrc^Edb, Gs^Fds, Urb, Ms^Xm, Qxua, Qxua, Qxua, Qxua, Qxua, Qlf, Aa, Aa, Aa, Aa^Fma, Ha, Qxua, Qxua
Qxua, Qxua, Qxua, Qxua, Qxua, Hd, Hd, Qlf^Bw\, Qlf^Bw\, Qlf, Ds, Hhd^Vhhr, Rrc, Dd^Ftd, Dd^Ftd, Urb, Gs^Fds, Rrc^Edb, Gs^Fds, Urb, Rrc, Ha, Rrc, Aa^Vla, Rrc, Qlf, Qlf^Bw/, Qlf^Bw/, Qxua, Qxua, Qxua, Qxua, Qxua, Qxua
Qxua, Qxua, Qxua, Qxua, Qxua, Qxua, Qxua, Qxua, Qxua, Dd^Ftd, Dd^Ftd, Rrc, Hd, Rrc, Rrc, Rrc, Rrc, Rrc, Rrc, Rrc, Rb^Fdyu, Rrc, Gll, Rrc, Aa^Fma, Aa^Fma, Qxua, Qxua, Qxua, Qxua, Qxua, Qxua, Qxua, Qxua
Qxua, Qxua, Qxua, Qxua, Qxua, Qxua, Qxua, Qxua, Qxua, Qxua, Qxua, Hhd^Vhhr, Qxua, Rd, Qxua, Qxua, Qxua, Qxua, Qxua, Rb^Fdyu, Qxua, Rb^Fdyu, Qxua, Ha^Vhha, Qxua, Qxua, Qxua, Qxua, Qxua, Qxua, Qxua, Qxua, Qxua, Qxua
Gg, Qxua, Qxua, Qxua, Qxua, Qxua, Qxua, Qxua, Qxua, Qxua, Qxua, Qxua, Qxua, Qxua, Qxua, Qxua, Qxua, Qxua, Qxua, Qxua, Qxua, Qxua, Qxua, Qxua, Qxua, Qxua, Qxua, Qxua, Qxua, Qxua, Qxua, Qxua, Qxua, Gg
